	Y0	Y1	Y2	Y3	Y4	Y5	Y6	Y7	Y8	Y9
X0	0	0	0	0	0	0	0	0	0	0
X1	0	0	0	0	0	0	0	0	0	0
X2	0	0	0	0	0	0	0	0	0	0
X3	0	0	0	0	0	0	0	0	0	0
X4	0	0	0	0	0	0	0	0	0	0
X5	0	0	0	0	0	0	0	0	0	0
X6	0	0	0	0	0	0	0	0	0	0
X7	0	0	0	0	0	0	0	0	0	0
X8	0	0	0	0	0	0	0	0	0	0
X9	0	0	0	0	0	0	0	0	0	0
	Y0	Y1	Y2	Y3	Y4	Y5	Y6	Y7	Y8	Y9
X0	1	1	1	1	1	1	1	1	1	1
X1	1	1	1	12	3	11	3	17	3	1
X2	1	1	1	5	11	9	6	5	1	1
X3	1	1	1	15	7	2	10	6	1	1
X4	1	1	1	8	1	1	4	13	1	1
X5	1	1	1	1	1	1	1	4	1	1
X6	1	1	1	1	1	1	1	4	1	1
X7	1	1	1	1	1	1	1	2	1	1
X8	1	1	2	2	3	3	4	6	1	1
X9	1	1	2	2	2	3	2	2	1	1
	Y0	Y1	Y2	Y3	Y4	Y5	Y6	Y7	Y8	Y9
X0	0	0	0	0	0	0	0	0	0	0
X1	0	0	0	0	0	0	0	0	0	0
X2	0	0	0	0	0	0	0	0	0	0
X3	0	0	0	0	0	0	0	0	0	0
X4	0	0	0	0	0	0	0	0	0	0
X5	0	0	0	0	0	0	0	0	0	0
X6	0	0	0	0	0	0	0	0	0	0
X7	0	0	0	0	0	0	0	0	0	0
X8	0	0	0	0	0	0	0	0	0	0
X9	0	0	0	0	0	0	0	0	0	0
	Y0	Y1	Y2	Y3	Y4	Y5	Y6	Y7	Y8	Y9
X0	1	1	2	13	5	9	5	6	1	1
X1	1	1	4	13	2	7	2	3	1	1
X2	1	1	1	2	2	3	1	1	1	1
X3	1	1	1	2	2	3	1	3	1	1
X4	1	1	1	1	2	5	2	6	2	1
X5	1	1	1	1	4	2	2	6	4	1
X6	1	1	1	1	1	1	1	1	1	1
X7	1	1	1	1	1	1	1	1	1	1
X8	1	1	2	2	2	3	2	2	1	1
X9	2	1	2	2	2	3	2	2	1	1
